111111111111111111111111
10000cccccc0000000000001
100000000100000000000e01
1000000000000000c0000001
10000000010000p000000001
1000000c0000000c00000001
111111111111111111111111
