1111111111
10e0000001
10c00000p1
1111111101
1000000001
1000ccc001
100c000001
100000c001
1111111111

