1111111111
10e0000001
10c00000p1
1111111101
1c10000001
101ccc0011
100c000001
100000c001
1101111111
10000001c1
1c00000001
1111111111
