1111111111
10e0000001
10c00000p1
11111111
