1111111111
10e0000001
10c0000001
1111111111

