1111111111
10e000 001
10c00000p1
1111111111

